Humans: 200
RRRRRRRRRRRRRRR
R.............R
R.@...........R
R.............R
R.............R
R.............R
R.............R
R.............R
R.............R
R.............R
R.............R
R.............R
R.............R
R.............R
R.............R
R.............R
R.............R
R.............R
R.............R
R.............R
R.............R
R.............R
R.............R
R.............R
R.............R
R.............R
R.............R
R.............R
R.............R
R.............R
R.............R
R.............R
R.............R
R.............R
R.............R
R.............R
R.............R
R.............R
R.............R
R.............R
R.............R
R.............R
R.............R
R.............R
R.............R
R.............R
R.............R
R.............R
R.............R
R.............R
R.............R
R.............R
R.............R
R.............R
R.............R
R.............R
R.............R
R.............R
R.............R
R.............R
R.............R
R.............R
R.............R
R.............R
R.............R
R.............R
R.............R
R.............R
R.............R
R.............R
R.............R
R.............R
R.............R
R.............R
R.............R
R.............R
R.............R
R.............R
R.............R
R.............R
R.............R
R.............R
R.............R
R.............R
R.............R
R.............R
R.............R
R.............R
R.............R
R.............R
R.............R
R.............R
RRRRRRRRRRRRRRR